Ord
kevät - vår (årstid)
sana - ord 
mie - jeg 
olen - er 
mies - mann, kar, fyr 
sie - du   
olet - er 
nainen - kvinne 
mikä? - hva?
kuka? - hvem?
hän - han,hun
oon - er
minun – min/mi/mitt/mine
sinun – din/di/ditt/dine
hänen – hans/hennes
nimi - navn 
nyt -nå
ystävä - venn 
Hurraa! 
lämmin – varm/ varmt
helluntai - pinse

tiistai - tirsdag 
keskiviikko - onsdag (eg. midtuke) 
tuorestai - torsdag 
perjantai - fredag 
lau(v)antai - lørdag 
sunnuntai - søndag 
kesä - sommer 
tääpänä - i dag 
huomena - i morgen
eilen - i går 
ilo(i)nen - glad
pyhä - helg 
aamu - morgen 
päivä - dag 
ilta - kveld 
yö - natt 
mulla/minula oon - jeg har
sulla/sinula oon - du har
hällä/hänelä oon – han/hun har
met - vi 
olema - er
tet - dere 
oletta - er
het - de (personlig pron.) 
Liten repetisjon:
olla - å være
1. person entall: (mie) olen
2. person entall: (sie) olet
3. person entall: hän oon
1. pers.flertall: (met) olema
2. pers.flertall: (tet) oletta
3. pers. flertall: het oon
ja - og 
meilä oon - vi har 
teilä oon - dere har
heilä oon - de har. 
heti – snart, straks
peret - familie
mamma ja pappa
poika – gutt, sønn
tytär - jente, datter 
ämmi - bestemor
äiji - bestefar 
sisar - søster
veli - bror 
iso - stor 
pikku - liten 
nuori - ung 
vanhaa - gammel 
uusi – ny/nytt
talo – hus/huset
mutta - men
sää - vær 
huono - dårlig 
sääski - mygg 
aurinko – sol/sola 
paistaa - steker, skinner 
sattaa - regner 
tuulee - blåser 
tyven – vindstille, havblikk

kylmä – kald/kaldt
pouta - oppholdsvær
pilvi - sky (på himmelen)

kiitos - takk
ole hyvä! - vær så god! 

olkkaa hyvät - vær så god!
missä? - hvor? 
tässä - her (på det stedet her)
tuossa - der (på det stedet der, brukes når man peker og sier "tuossa")
täälä - her (her i området ett eller annet sted, ikke noe bestemt sted, men her!)
tuola - der, der borte (peker i en retning, "der" i området ett eller annet sted, ikke noe bestemt sted, men der!)
hilla - multe
yks(i) en (tallord)
kaks(i) - to
kolme - tre
nelje/neljä - fire 
viis(i) - fem 
Yks, kaks, kolme, nelje, viis,
Jää sie siiheen siis.
ukkossää - tordenvær 
meri – sjø/sjøen, hav/havet
vuono – fjord/fjorden 
järvi – innsjø/innsjøen, vann/vannet
joki – elv/elva
oja – bekk/bekken
mettä – skog/skogen
vaara – fjell/fjellet
tunturi – fjell/fjellet (større sammenhengende fjellområde) 
jänkkä/jänkä - myr,myra
kenttä – eng/enga
kukka – blomst/blomsten
syyskesä – høstsommer/høstsommeren, seinsommer/seinsommeren
asun – (jeg) bor
asut – (du) bor
assuu – (han,hun) bor
asuma – (vi) bor
asutta (dere) bor
asuthaan - (de) bor 
-ssa,-ssä - i (inne i)
Alattio - Alta
Peruna - Bergen 
Tromssa - Troms(ø)
Kiiperi - Kiberg
Vesisaari - Vadsø 


Pyssyjoki - Børselv 
Suomi - Finland 
Ruotti - Sverige 
kotona - hjemme 
syksy – høst,høsten 
kaunis – pen,pent
istuu - sitter
lintu – fugl, fuglen
oksa - grein/greina 
istun - (jeg) sitter 
istut - (du) sitter 
istuma - (vi) sitter
istutta – (dere) sitter
istuthaan (de) sitter
-sta/-stä - ut av, fra
puola – tyttebær/tyttebæra
mustikka - blåbær/blåbæra 
variksenmarja - krøkebær/krøkebæra, krekling/krekling 
sieni – sopp/soppen
punanen - rød/rødt 
keltanen - gul/gult 
sininen – blå/blått 
vihrinen/vihreä - grønn/grønt 
kranni – granne/grannen, nabo/naboen
harakka – skjære/skjæra, skjur(e)/skjura
puu – tre/treet
koivu – bjørk/bjørka
lehti – blad/bladet, løv/løvet
pihlaja – rogn/rogna
haapa – osp/ospa
paiju/paivu – selje/selja
leppä  - older/olderen (gråor/gråora)
hakopuu - bartre
petäjä/pötäjä – furu/furua
kuusi - gran/grana
kissa – katt/katta
koira - hund/hunden 
kaffi – kaffe/kaffen
juusto – ost/osten
sokkeri – sukker/sukkeret
maito - melk/melka 
piimä - surmelk/surmelka, kefir, kulturmelk 
vesi – vann/vannet
pakkanen - kulde/kulda 
lumi – snø/snøen
jää - is/isen 
tulen – jeg kommer
tulet – du kommer
hän tullee – han/hun kommer
tulema – vi kommer
tuletta - dere kommer
tulhaan - de kommer 
menen - jeg går/drar
Alattihoon - til Alta
menet - du går/drar
mennee - han/hun går/drar
menemä - vi går/drar
menettä - dere går/drar
menhään - de går/drar
-ko/-kö - ?
menemäkö? - går/drar vi?
oletko? - er du?
kirkko - kirke/kirka
olenko? - er jeg?
kauppa - butikk/butikken
loppunu - slutta/sluttet
aika - tid/tida
alkanu - begynt
matala – lav/lavt
pyhämiesten päivä - allehelgensdag 

kaljama - hålkeføre/hålkeføret
lyhyt - kort (ikke lang)
pitke/pitkä - lang/langt 
korkea/korkkee - høy/høyt
raskas - tung/tungt
keveä/kevvee - lett
isänpäivä – farsdag/farsdagen
(isä – far/faren)
(onni – lykke/lykken)
lauha - mildvær/mildværet
hevonen - hest/hesten
pappi - prest/presten
suola - salt/saltet
kaikki - alt/alle
tormi - storm/stormen
tuisku – fokk/fokket
en ole - jeg er ikke
en mene - jeg går/drar ikke
en istu - jeg sitter ikke
en tule - jeg kommer ikke
et ole - du er ikke
et asu - du bor ikke
ei tule - han/hun/den/det kommer ikke
ei mene - han/hun/den/det går ikke
emmä ole - vi er ikke
ei/eivät asu - de bor ikke
vaimo - kone/kona, hustru/hustrua
vaimon - konas, hustruas
isän - farens
ensi - første/den første/det første/de første
äitin - moras
krannin - grannes/grannens, nabos/naboens
hevosen - hestens

pojan - guttens
papan - pappas
Pekan - Pekkas
toinen – andre/annen
katto - tak/taket
katola - på taket
tyttärelä oon - dattera/jenta
har
miehen - mannens/karens
piili - bil/bilen
kolmastoista - trettende (13.)
kaamos – mørketid/mørketida
kolmas – tredje/den tredje
hoppu – travelt
pimeä/pimiä/pimmee – mørk/mørkt
kirjotan – jeg skriver
joulukortti – julekort/julekortet
joulukenkki – julegave/julegaven
joulupuu – juletre/juletreet
aijankäännet – tidssnu 
neljes/neljäs – fjerde/den fjerde
aatto – aften/aftenen
aatonaatto – lille julaften
jouluaatto – julaften/julaftenen

ensi joulupäivä – første juledag
toinen joulupäivä – andre juledag
joulupetäjä/joulupötäjä – juletre av furu
joulutähti - julestjerne/julestjerna

joulun ja loppiaisen välinen aika – romjul
vuosi – år/året
uuðenvuoðenaatto/uuenvuoenaatto - nyttårsaften

2014
Hyvvää/onnelista/rauhalista uutta vuotta! 
jatkuuvasti - fortsatt
januaari(kuu) - januar(måned)
kuu - måne(d)/måne(de)n
sivakka - (en) ski/skien
sivakat - skiene 
sauva - stav/staven
sompa - trinse/trinsa
keli - føre/føret
latu/lattuu - skispor/skisporet

talvi - vinter/vinteren

liukas - glatt





















